11111111111111111
10000CC0C000000C1
100000000000000C1
1P000000000000001
10000000000000001
10000000000C00001
11111111111111111