11111111111111111
1CCCCCCCCCCCCCCC1
1CCCCCCCCCCCCCCC1
1CCCCCCCCCCCCCCC1
1CCCECCCCCCCCCCC1
1CCCCCCCCCCCCCCC1
1CCCCCCCCCCCCCCC1
1CCCCCCC1CCCCCCC1
1CCCCCCCCCCCCCCC1
1CCCCCCCCCCCCCCC1
1CCCCCCCCCPCCCCC1
1CCCCCCCCCCCCCCC1
11111111111111111