11111111111111111
10000PC10000000C1
100011110000000C1
1000001C100000001
1000C000000000001
10000000000C00001
10000000000C00001
10000000000C00001
10000000000C00001
10000000000C00001
10000000000C00001
10000000000C00001
10000000000C00001
10000000000C00111
10000000000C000E1
11111111111111111