1111111111111
1C01000000001
10000111E1001
1P00110000001
1111111111111