11111111111111111
10000CC0C000000C1
100000000000000C1
10000000000000001
1000P000000000001
10000000000C00001
10000000000C00001
10000000000C00001
10000000000C00001
10000000000C00001
10000000000C00001
10000000000C00001
10000000000C00001
10000000000C00011
10000000000C001E1
11111111111111111