11111111111111111
10001CC1C000000C1
100000001000000C1
1000001C100000001
1000P000000000001
10000000000C00001
10000000000C00001
10000000000C00001
10000000000C00001
10000000000C00001
10000000000C00001
10000000000C00001
10000000000C00001
10000000000C00111
10000000000C000E1
11111111111111111